20
20
OOOOOOOOOOOOOXOOOOOX
OXXXOXXOXXXXOXXOXXOX
OXXXOOOOOXXXOOOOXXXX
OXXXOXXXXXXXOXXXXOOX
OXXXOXXXXXXXOXXOOOXX
OOOOXXXOOOOOOOOOXOXX
OXXXXOXOXXXXXXXXXOXX
OOOOOOXOXOOOOOOOOOXX
OXXXXXXOXXOXXXXXXXXX
OOOOOOOOXXOOOOOOOXXX
OXXXOXXXXXXXOXXXOOOO
OXOXOXOOOOOOOXXXOXXO
OXOXXXOXOXXOXOOOOXXO
OOOOOOOXXXXXXOXXOXXO
XOXXXXXXOOOOXOXXOXXX
XOXOOXXOOXXOXOOXOOOX
XOXXOXXOXXXOXXXXXXOX
XOXXOOOOOXXOXXOOOOOX
XOOOOXXXXXXOXXOXXXXX
XOXXOXOOOOOOOOOOO0OOZ
